111111111011111111111111
100000000001E10000011C11
1P0000000001110000C00111
111111111111111111111111