111111111111111111111111
1E0000000000000000000C11
1P0000000000000C00000111
111111111111111111111111
