111111111111111111111111
1E0000000000000000000011
1C0000000000000000000111
1C0000000000000000000111
1P0000000000000000000111
111111111111111111111111
