111111111111111111111111
1E0000000000000000000C11
100000000000000C00000111
100000000000000000000001
100000000000000000000001
1P0000000C00000000000001
111111111111111111111111
