111111111111111111111111
1E0000000000000000000C11
1000000000C000C000001111
1000000000C000C000CCC001
1000000000CCCCC00000C001
1P0000000000000000CCC001
111111111111111111C11111
111111111111111111CCCCC1
111111111111111111111111