111111
1PEC01
100001
111111
000000
